

1111111111111111111111111111111111111
1000000000000000000000000000000000001
1000011111111011111111111111101111111
1000011000000000001101000000000000101
1000011000000000001100010010010010001
1000000000001111111111111111111111111
10111111111000000000001
10000000001111111110111
11111111101000111110101
10000000001000000000001
11111111111111111111111