SO ./images/wall_south.xpm     

       WE ./images/wall_west.xpm

NO        ./images/wall_north.xpm
EA ./images/wall_east.xpm

F 179,103,0

      C                 0,255,255

111111111111111111111
10E000000000000000001
100000001111101111111        00000
100001100000000000111
111111111111111111111
