SO ./images/wall_south.xpm     

       WE ./images/wall_west.xpm

NO                  ./images/wall_north.xpm
EA ./images/wall_east.xpm

F 179,103,0

      C                 0,255,255

1111111111111111111111111111111111111
1001000000000000000000000000000000001
1000000011111011111111111111101111111        00000
10000110000S0000001101000000000000101
1000011000010000001100010010010010001
10000000000001111111111111111111111111
10111111100001000000000001
10000000011111111011111111
11111001110100011110010111   
11110000000001000000000001
  11111111111111111111111
