SO ./images/wall_south.xpm     

       WE ./images/wall_west.xpm

NO                  ./images/wall_north.xpm
EA ./images/wall_east.xpm

F 179,103,0

      C                 18,13,12

1111111111111111111111111111111111111
1000000000000000000000000000000000001
1000000011111011111111111111101111111        00000
1000011000000000001101000000000000101
10N0011000010000001100010010010010001
1000000000001111111111111111111111111
10011111100001000000000001
10000000011111111011111111
11111001110100011110010111   
11110000000001000000000001
  11111111111111111111111
